"Western Arabic (European)"	0123456789
"Eastern Arabic (Indic)"	┘а┘б┘в┘г┘д┘е┘ж┘з┘и┘й
"Persian"	█░█▒█▓█│█┤█╡█╢█╖█╕█╣
"Devanagari"	режрезреирейрекрелремренреореп
"Gujarati"	рлжрлзрлирлйрлкрллрлмрлнрлорлп
"Gurmukhi"	рйжрйзрйирййрйкрйлрймрйнрйорйп
"Limbu"	сеЖсеЗсеИсеЙсеКсеЛсеМсеНсеОсеП
"Assamese and Bengali"	рзжрззрзирзйрзкрзлрзмрзнрзорзп
"Oriya"	рнжрнзрнирнйрнкрнлрнмрннрнорнп
"Telugu"	р▒жр▒зр▒ир▒йр▒кр▒лр▒мр▒нр▒ор▒п
"Kannada"	р│жр│зр│ир│йр│кр│лр│мр│нр│ор│п
"Malayalam"	р╡жр╡зр╡ир╡йр╡кр╡лр╡мр╡нр╡ор╡п
"Tamil (Grantha)"	р│жрпзрпирпйрпкрплрпмрпнрпорпп
"Tibetan"	р╝ар╝бр╝вр╝гр╝др╝ер╝жр╝зр╝ир╝й
"Burmese"	сБАсББсБВсБГсБДсБЕсБЖсБЗсБИсБЙ
"Thai"	р╣Рр╣Ср╣Тр╣Ур╣Фр╣Хр╣Цр╣Чр╣Шр╣Щ
"Khmer"	сЯасЯбсЯвсЯгсЯдсЯесЯжсЯзсЯисЯй
"Lao"	р╗Рр╗Ср╗Тр╗Ур╗Фр╗Хр╗Цр╗Чр╗Шр╗Щ
"Lepcha"	с▒Ас▒Бс▒Вс▒Гс▒Дс▒Ес▒Жс▒Зс▒Ис▒Й
"Balinese"	снРснСснТснУснФснХснЦснЧснШснЩ
"Sundanese"	со░со▒со▓со│со┤со╡со╢со╖со╕со╣
"Ol Chiki"	с▒Рс▒Сс▒Тс▒Ус▒Фс▒Хс▒Цс▒Чс▒Шс▒Щ
"Osmanya"	ЁРТаЁРТбЁРТвЁРТгЁРТдЁРТеЁРТжЁРТзЁРТиЁРТй
"Saurashtra"	ъгРъгСъгТъгУъгФъгХъгЦъгЧъгШъгЩ
"Mongolian"     саРсаСсаТсаУсаФсаХсаЦсаЧсаШсаЩ

